##########
#^ #* *#%#
## #F# #*#
#  D #$#*#
#^## # # #
#  # #D#*#
#  # #F**#
##########