###########   #########
#^^ * * **#####  *****#
#^ ##* #**D $$$  *****#
#  #**##*##############
#D##*##**D^^ #***#***#
#F# **#*## #***#***#*#
#F###*#**#############
#*** *##*D ^^^ #
#%#***FD*#######
##########