############
#^^ * * * *#
#* * * #* %#
#  # * D* *#
# ##   ##*##
# ##    # *#
############