##################################
#^^^* *#* *  ********************#
#* * * #*  ######## ##############
# # *  D* *#  ^^^ # ************ #
# # *  ##*##******############## #
# # **    *#******# ************ #
# #F#### ### #### # ##############
# # # *% **#      # ************ #
# # #        #### ############## #
#D######D###      # ************ #
#  ****#***# #### # ##############
#F####*###*#      D    #   ****  #
#**********#      #    **** # ^^^#
##################################