##########
#^ #***#%#
#**#*#*#*#
#****#***#
##########