######## #
# #* * #%#
#^#F## #*#
# #  #$#*#
#^## #*# #
#  #*#D#*#
 **D*#F**#
##########