##########
#^ #* *#%#
## #F#D#*#
#**D #F**#
##########