###########
#^^ * * **#######
#^ *#* #**D $$$ #
#  #**##*#############
#  #*##**D   #   #   #
#  #**#*## #   #   # #
#FF##*#**#############
#***#*##**D ^^^ #
#%#***FD**#######
###########