#   ###################
^   #                 #
#####                 #
#        *        ^   #
#        ^**          #
#                     #
#        *            #
#             *       #
#                     #
#        %            #
#                     #
#######  ##############