###########
#^^ * * **#
#* * * #* #
#  # * D* #
###########