#######################
#                     #
#                     #
#        *        ^   #
#        ^**          #
#                     #
#        *            #
#             *       #
#                     #
#        %            #
#                     #
#######################