###########
#^^       #
#        *#
#         #
#         #
# * F %   #
###########
