###########
#^^       #
#        *#
#         #
#         #
# *   %   #
###########