###########
#^^ * * **#
#* * * #* #
#% # * D* #
###########