##########
#^^ * *# #
#* *#*%# #
#      # #
##########