##########
#*#* * #%#
#^#F## #*#
# #  #$#*#
#^## #*# #
#  #*#D#*#
#**D*#F**#
##########