###################
#^^ * *#* *  **** #
#* * * #*  ########
# # *  D* *#   ^  #
# # *  ##*##******#
# # **    *#******#
# ###### ###      #
#^   D*% **#      #
###################